1111111111111111111111111111111
1E000000000000C000000C000000001
1010010100100000101001000001011
101000010000000100000C000000001
1P00000000C000000000000000000C1
1111111111111111111111111111111